11111111111111111111111111111111
10000000000C00000000000100000001
10EP000000C0000000C0000100000001
1000000000000000000000000000C001
1000000C0100000000000000C0000001
10C0000001000000000C000000000001
11111111111111111111111111111111