1111111111111111111111111111111111111
1000000000000000000000000000000000001
100C0000000CCC000C0000000C00CCCCC0001
100C000000C000C000C00000C000C00000001
100C000000C000C0000C000C0000CCCC00001
100C000000C000C00000C0C00000C00000001
100CCCCC000CCC0000000C000000CCCCC0001
1000000000000000000000000000000000001
10000000000000000EP000000000000000001
1000000000000000000000000000000000001
1CCCCC0000C00000C0000000C00000C000001
100C00000C0C0000CC00000CC0000C0C00001
100C0000CCCCC000C0C000C0C000CCCCC0001
100C000C00000C00C00C0C00C00C00000C001
100C00C0000000C0C000C000C0C0000000C01
1000000000000000000000000000000000001
1111111111111111111111111111111111111