111111111111111111111111111111111111111111111111111111111111111111111
100000000000000000000000000000000000000000000000000000000000000000001
10C000000CCC00C0000000C0CCCCC0000CCCCC0000C00000C0000000C00000C000001
10C00000C000C00C00000C00C0000000000C00000C0C0000CC00000CC0000C0C00001
10C00000C000C000C000C000CCCC000EP00C0000CCCCC000C0C000C0C000CCCCC0001
10C00000C000C0000C0C0000C0000000000C000C00000C00C00C0C00C00C00000C001
10CCCCC00CCC000000C00000CCCCC000000C00C0000000C0C000C000C0C0000000C01
100000000000000000000000000000000000000000000000000000000000000000001
111111111111111111111111111111111111111111111111111111111111111111111