111111111111111111111111111111111111111111111111111111111111111111111
100000000000000000000000000000000000000000000000000000000000000000001
100100000011100100000001011111000011111000011000001000001000001000001
100100000100010010000010010000000000100000100100001100011000010100001
10010000010001000100010001111000EP00100001111110001010101000111110001
100100000100010000101000010000000000100010000001001001001001000001001
100111110011100000010000011111000000100100000000101001001010000000101
100000000000000000000000000000000000000000000000000000000000000000001
111111111111111111111111111111111111111111111111111111111111111111111