111111111111111111111111111111111
100000000000000000000000000000001
100100000011100100000001011111001
100100000100010010000010010000001
100100000100010001000100011110001
100100000100010000101000010000001
100111110011100000010000011111001
100000000000000000000000000000001
111111111111111111111111111111111
1P0000C0000C0000C0000C0000C0000E1
111111111111111111111111111111111
100000000000000000000000000000001
101111100011000010000010000100001
100010000100100011000110001010001
100010001111110010101010011111001
100010010000001010010010100000101
100000000000000000000000000000001
111111111111111111111111111111111