111111111
1C00000C1
100000001
100000001
1000EP001
100000001
100000001
1C00000C1
111111111