111111111111111111111
100000000100000000001
100000000100000000001
1000C0000100000000E01
10P000000100000000001
100000000100000000001
111111111111111111111
