111111111111
100000000CP1
100000000001

1000CC000001
10000000E001
100000000001
111111101111