11111111111111111111111111111111
10000000000000000000000000000001
10000000000000000000000011111001
10010000001110001000001010000001
10010000010001000100010011110001
10010000010001000010100010000001
10011111001110000001000011111001
10000000000000000000000000000001
11111111111111111111111111111111
1P0000C0000C0000C0000C0000C000E1
11111111111111111111111111111111
100000000000000000000000000000011
10111110001100001000001000010001
10001000010010001100011000101001
10001000111111001010101001111101
10001001000000101001001010000011
10000000000000000000000000000001
11111111111111111111111111111111