111111111
1P0P00001
1E0C00001
111111111